111111111111111
100100000000211
100100000000011
101100000100011
100210000100011
100000000000011
100000000100000
100000000000000
100001000000000
111111111111111
